// MilkShape 3D ASCII

Frames: 30
Frame: 1

Meshes: 1
"Regroup01" 1 0
35
1 1.887403 -0.440476 -0.000999 0.000000 0.000000 -1
1 1.526941 -0.440476 1.108389 0.000000 0.000000 -1
1 0.000000 -0.440476 -0.000999 0.000000 0.000000 -1
1 1.887403 0.481034 -0.000999 0.000000 0.000000 -1
1 0.000000 0.481034 -0.000999 0.000000 0.000000 -1
1 1.526941 0.481034 1.108389 0.000000 0.000000 -1
1 1.887403 -0.440476 -0.000999 0.000000 1.000000 -1
1 1.526941 -0.440476 1.108389 0.100000 1.000000 -1
1 1.526941 0.481034 1.108389 0.100000 0.000000 -1
1 0.583240 -0.440476 1.794029 0.000000 0.000000 -1
1 0.583240 0.481034 1.794029 0.000000 0.000000 -1
1 0.583240 0.481034 1.794029 0.200000 0.000000 -1
1 0.583240 -0.440476 1.794029 0.200000 1.000000 -1
1 -0.583240 -0.440476 1.794029 0.000000 0.000000 -1
1 -0.583240 0.481034 1.794029 0.000000 0.000000 -1
1 -0.583240 -0.440476 1.794029 0.300000 1.000000 -1
1 -0.583240 0.481034 1.794029 0.300000 0.000000 -1
1 -1.526942 -0.440476 1.108389 0.000000 0.000000 -1
1 -1.526942 0.481034 1.108389 0.000000 0.000000 -1
1 -1.526942 0.481034 1.108389 0.400000 0.000000 -1
1 -1.526942 -0.440476 1.108389 0.400000 1.000000 -1
1 -1.887404 -0.440476 -0.000999 0.000000 0.000000 -1
1 -1.887404 0.481034 -0.000999 0.000000 0.000000 -1
1 -1.887404 -0.440476 -0.000999 0.500000 1.000000 -1
1 -1.887404 0.481034 -0.000999 0.500000 0.000000 -1
1 -1.497239 0.481034 -2.001476 0.600000 0.000000 -1
1 -1.497239 -0.440476 -2.001476 0.600000 1.000000 -1
1 1.497239 -0.440476 -2.001476 0.900000 1.000000 -1
1 1.497239 0.481034 -2.001476 0.900000 0.000000 -1
1 1.887403 0.481034 -0.000999 1.000000 0.000000 -1
1 1.887403 -0.440476 -0.000999 1.000000 1.000000 -1
1 -1.497239 0.481034 -2.001476 0.000000 0.000000 -1
1 1.497239 0.481034 -2.001476 0.000000 0.000000 -1
1 -1.497239 -0.440476 -2.001476 0.000000 0.000000 -1
1 1.497239 -0.440476 -2.001476 0.000000 0.000000 -1
16
0.000000 -1.000000 0.000000
0.000000 1.000000 0.000000
0.694259 -0.718485 0.042243
0.886849 0.458898 0.053961
0.809017 0.000000 0.587785
0.809017 0.000000 0.587785
0.309017 0.000000 0.951056
-0.309017 0.000000 0.951056
-0.809017 0.000000 0.587785
-0.809017 0.000000 0.587785
-0.966447 -0.250043 0.058804
-0.886849 0.458898 0.053961
-0.533644 0.543698 -0.647778
-0.388495 -0.791630 -0.471586
0.604894 -0.308146 -0.734268
0.533644 0.543698 -0.647778
30
1 0 1 2 0 0 0 2
1 3 4 5 1 1 1 2
1 6 3 7 2 3 4 1
1 3 8 7 3 5 4 1
1 1 9 2 0 0 0 2
1 5 4 10 1 1 1 2
1 7 8 11 4 5 6 1
1 7 11 12 4 6 6 1
1 9 13 2 0 0 0 2
1 10 4 14 1 1 1 2
1 12 11 15 6 6 7 1
1 11 16 15 6 7 7 1
1 13 17 2 0 0 0 2
1 14 4 18 1 1 1 2
1 15 16 19 7 7 8 1
1 15 19 20 7 8 9 1
1 17 21 2 0 0 0 2
1 18 4 22 1 1 1 2
1 20 19 23 9 8 10 1
1 19 24 23 8 11 10 1
1 23 24 25 10 11 12 1
1 23 25 26 10 12 13 1
1 27 28 29 14 15 3 1
1 27 29 30 14 3 2 1
1 31 22 3 12 11 3 1
1 3 32 31 3 15 12 1
1 21 33 0 10 13 2 1
1 0 33 34 2 13 14 1
1 31 32 34 12 15 14 1
1 34 33 31 14 13 12 1

Materials: 1
"step colour"
0.933333 0.101961 0.705882 1.000000
0.933333 0.101961 0.705882 1.000000
0.000000 0.000000 0.000000 1.000000
0.000000 0.000000 0.000000 1.000000
0.000000
1.000000
""
""

Bones: 0
