// MilkShape 3D ASCII

Frames: 30
Frame: 1

Meshes: 7
"Box01" 0 0
15
1 58.202168 -6.528602 120.138863 1.000000 0.000000 -1
1 58.202168 -6.528602 75.472206 1.000000 0.250000 -1
1 13.535490 -6.528602 75.472206 0.750000 0.250000 -1
1 -120.464539 -6.528602 -58.527763 0.000000 1.000000 -1
1 -75.797867 -6.528602 -13.861111 0.250000 0.750000 -1
1 -75.797867 -6.528602 -58.527763 0.250000 1.000000 -1
1 58.202168 -6.528602 -58.527763 1.000000 1.000000 -1
1 13.535490 -6.528602 -58.527763 0.750000 1.000000 -1
1 58.202168 -6.528602 -13.861111 1.000000 0.750000 -1
1 -31.131180 -6.528602 30.805544 0.500000 0.500000 -1
1 13.535490 -6.528602 30.805544 0.750000 0.500000 -1
1 58.202168 -6.528602 30.805544 1.000000 0.500000 -1
1 -31.131180 -6.528602 -58.527763 0.500000 1.000000 -1
1 -31.131180 -6.528602 -13.861111 0.500000 0.750000 -1
1 13.535490 -6.528602 -13.861111 0.750000 0.750000 -1
1
0.000000 1.000000 0.000000
10
1 0 1 2 0 0 0 3
1 3 4 5 0 0 0 3
1 6 7 8 0 0 0 3
1 9 2 10 0 0 0 3
1 11 10 1 0 0 0 3
1 12 5 13 0 0 0 3
1 9 13 4 0 0 0 3
1 11 8 14 0 0 0 3
1 12 14 7 0 0 0 3
1 14 13 10 0 0 0 3
"Regroup01" 0 1
3
1 -75.797867 -6.528602 -13.861111 0.250000 0.750000 -1
1 -31.131180 -6.528602 -13.861111 0.500000 0.750000 -1
1 -75.797867 -6.528602 -58.527763 0.250000 1.000000 -1
1
0.000000 1.000000 0.000000
1
1 0 1 2 0 0 0 3
"Regroup02" 0 1
3
1 -31.131180 -6.528602 -58.527763 0.500000 1.000000 -1
1 -31.131180 -6.528602 -13.861111 0.500000 0.750000 -1
1 13.535490 -6.528602 -13.861111 0.750000 0.750000 -1
1
0.000000 1.000000 0.000000
1
1 0 1 2 0 0 0 3
"Regroup03" 0 1
3
1 13.535490 -6.528602 -58.527763 0.750000 1.000000 -1
1 13.535490 -6.528602 -13.861111 0.750000 0.750000 -1
1 58.202168 -6.528602 -13.861111 1.000000 0.750000 -1
1
0.000000 1.000000 0.000000
1
1 0 1 2 0 0 0 3
"Regroup04" 0 1
3
1 -31.131180 -6.528602 30.805544 0.500000 0.500000 -1
1 13.535490 -6.528602 30.805544 0.750000 0.500000 -1
1 -31.131180 -6.528602 -13.861111 0.500000 0.750000 -1
1
0.000000 1.000000 0.000000
1
1 0 1 2 0 0 0 3
"Regroup05" 0 1
3
1 58.202168 -6.528602 30.805544 1.000000 0.500000 -1
1 13.535490 -6.528602 -13.861111 0.750000 0.750000 -1
1 13.535490 -6.528602 30.805544 0.750000 0.500000 -1
1
0.000000 1.000000 0.000000
1
1 0 1 2 0 0 0 3
"Regroup06" 0 1
3
1 58.202168 -6.528602 75.472206 1.000000 0.250000 -1
1 13.535490 -6.528602 30.805544 0.750000 0.500000 -1
1 13.535490 -6.528602 75.472206 0.750000 0.250000 -1
1
0.000000 1.000000 0.000000
1
1 0 1 2 0 0 0 3

Materials: 2
"Material01"
0.200000 0.200000 0.200000 1.000000
0.501961 0.501961 1.000000 1.000000
0.000000 0.000000 0.000000 1.000000
0.000000 0.000000 0.000000 1.000000
0.000000
1.000000
""
""
"Material02"
0.200000 0.200000 0.200000 1.000000
0.905882 0.121569 0.278431 1.000000
0.000000 0.000000 0.000000 1.000000
0.000000 0.000000 0.000000 1.000000
0.000000
1.000000
""
""

Bones: 0
