// MilkShape 3D ASCII

Frames: 40
Frame: 1

Meshes: 3
"Regroup01" 1 0
82
1 2.035395 -0.479539 -0.000999 0.000000 1.000000 -1
1 2.035395 0.500565 -0.000999 0.000000 0.000000 -1
1 2.034224 -0.479539 1.108389 0.100000 1.000000 -1
1 2.034224 0.500565 1.108389 0.100000 0.000000 -1
1 1.094238 0.500565 2.001576 0.200000 0.000000 -1
1 1.094238 -0.479539 2.001576 0.200000 1.000000 -1
1 -1.093665 -0.479539 2.001576 0.300000 1.000000 -1
1 -1.093665 0.500565 2.001576 0.300000 0.000000 -1
1 -2.034136 0.500565 1.108389 0.400000 0.000000 -1
1 -2.034136 -0.479539 1.108389 0.400000 1.000000 -1
1 -2.035398 -0.479539 -0.000999 0.500000 1.000000 -1
1 -2.035398 0.500565 -0.000999 0.500000 0.000000 -1
1 -1.500736 0.500565 -2.000115 0.600000 0.000000 -1
1 -1.500736 -0.479539 -2.000115 0.600000 1.000000 -1
1 -0.583240 -0.479539 -1.999515 0.700000 1.000000 -1
1 -0.583240 0.500565 -1.999515 0.700000 0.000000 -1
1 0.583240 0.500565 -1.999920 0.800000 0.000000 -1
1 0.583240 -0.479539 -1.999920 0.800000 1.000000 -1
1 1.499164 -0.479539 -2.000115 0.900000 1.000000 -1
1 1.499164 0.500565 -2.000115 0.900000 0.000000 -1
1 2.035395 0.500565 -0.000999 1.000000 0.000000 -1
1 2.035395 -0.479539 -0.000999 1.000000 1.000000 -1
1 1.230699 -0.485508 0.889151 0.100000 1.000000 -1
1 1.543370 0.500264 0.000000 0.000000 0.000000 -1
1 1.543370 -0.485508 0.000000 0.000000 1.000000 -1
1 1.230699 0.500264 0.889151 0.100000 0.000000 -1
1 0.474342 0.500264 1.438677 0.200000 0.000000 -1
1 0.474342 -0.485508 1.438677 0.200000 1.000000 -1
1 -0.460569 -0.485508 1.438677 0.300000 1.000000 -1
1 -0.460569 0.500264 1.438677 0.300000 0.000000 -1
1 -1.216925 0.500264 0.889151 0.400000 0.000000 -1
1 -1.216925 -0.485508 0.889151 0.400000 1.000000 -1
1 -1.543797 -0.485508 0.000000 0.500000 1.000000 -1
1 -1.543797 0.500264 0.000000 0.500000 0.000000 -1
1 -1.216925 0.500264 -0.889151 0.600000 0.000000 -1
1 -1.216925 -0.485508 -0.889151 0.600000 1.000000 -1
1 -0.460569 -0.485508 -1.438677 0.700000 1.000000 -1
1 -0.460569 0.500264 -1.438677 0.700000 0.000000 -1
1 0.474342 0.500264 -1.438677 0.800000 0.000000 -1
1 0.474342 -0.485508 -1.438677 0.800000 1.000000 -1
1 1.230699 -0.485508 -0.889151 0.900000 1.000000 -1
1 1.230699 0.500264 -0.889151 0.900000 0.000000 -1
1 1.543370 0.500264 0.000000 1.000000 0.000000 -1
1 1.543370 -0.485508 0.000000 1.000000 1.000000 -1
1 -0.583240 0.500565 -1.999515 0.000000 0.000000 -1
1 -0.460569 0.500264 -1.438677 0.000000 0.000000 -1
1 0.583240 0.500565 -1.999920 0.000000 0.000000 -1
1 0.474342 0.500264 -1.438677 0.000000 0.000000 -1
1 1.499164 0.500565 -2.000115 0.000000 0.000000 -1
1 1.230699 0.500264 -0.889151 0.000000 0.000000 -1
1 2.034224 0.500565 1.108389 0.000000 0.000000 -1
1 1.230699 0.500264 0.889151 0.000000 0.000000 -1
1 1.094238 0.500565 2.001576 0.000000 0.000000 -1
1 0.474342 0.500264 1.438677 0.000000 0.000000 -1
1 -1.093665 0.500565 2.001576 0.000000 0.000000 -1
1 -0.460569 0.500264 1.438677 0.000000 0.000000 -1
1 -2.034136 0.500565 1.108389 0.000000 0.000000 -1
1 -1.216925 0.500264 0.889151 0.000000 0.000000 -1
1 -2.035398 0.500565 -0.000999 0.000000 0.000000 -1
1 -1.543797 0.500264 0.000000 0.000000 0.000000 -1
1 -1.500736 0.500565 -2.000115 0.000000 0.000000 -1
1 -1.216925 0.500264 -0.889151 0.000000 0.000000 -1
1 1.094238 -0.479539 2.001576 0.000000 0.000000 -1
1 -1.093665 -0.479539 2.001576 0.000000 0.000000 -1
1 -0.460569 -0.485508 1.438677 0.000000 0.000000 -1
1 0.474342 -0.485508 1.438677 0.000000 0.000000 -1
1 1.230699 -0.485508 0.889151 0.000000 0.000000 -1
1 2.034224 -0.479539 1.108389 0.000000 0.000000 -1
1 1.543370 -0.485508 0.000000 0.000000 0.000000 -1
1 2.035395 -0.479539 -0.000999 0.000000 0.000000 -1
1 1.230699 -0.485508 -0.889151 0.000000 0.000000 -1
1 1.499164 -0.479539 -2.000115 0.000000 0.000000 -1
1 0.474342 -0.485508 -1.438677 0.000000 0.000000 -1
1 0.583240 -0.479539 -1.999920 0.000000 0.000000 -1
1 -0.460569 -0.485508 -1.438677 0.000000 0.000000 -1
1 -0.583240 -0.479539 -1.999515 0.000000 0.000000 -1
1 -1.216925 -0.485508 -0.889151 0.000000 0.000000 -1
1 -1.500736 -0.479539 -2.000115 0.000000 0.000000 -1
1 -1.543797 -0.485508 0.000000 0.000000 0.000000 -1
1 -2.035398 -0.479539 -0.000999 0.000000 0.000000 -1
1 -1.216925 -0.485508 0.889151 0.000000 0.000000 -1
1 -2.034136 -0.479539 1.108389 0.000000 0.000000 -1
66
0.999999 0.000000 0.001055
0.554362 0.832275 0.000685
0.918712 0.000000 0.394927
0.370862 0.000000 0.928688
-0.370742 0.000000 0.928736
-0.370743 0.000000 0.928736
-0.918645 0.000000 0.395083
-0.918645 0.000000 0.395083
-0.991549 0.000000 -0.129731
-0.991549 0.000000 -0.129731
-0.608687 0.000000 -0.793410
0.000154 0.000000 -1.000000
0.000154 0.000000 -1.000000
-0.000280 0.000000 -1.000000
0.608571 0.000000 -0.793499
0.965857 0.000000 -0.259076
-0.801910 0.000000 -0.597445
-0.523607 0.831865 -0.183948
-0.943372 0.000000 -0.331737
-0.309017 0.000000 -0.951056
0.309017 0.000000 -0.951056
0.797665 0.000000 -0.603100
1.000000 0.000000 0.000000
0.797665 0.000000 0.603100
0.309017 0.000000 0.951056
-0.309017 0.000000 0.951056
-0.801910 0.000000 0.597445
-0.943372 0.000000 0.331737
0.000112 1.000000 0.000424
0.000112 1.000000 0.000513
0.000000 1.000000 0.000538
-0.000056 1.000000 0.000435
-0.000233 1.000000 0.000304
-0.000438 1.000000 0.000196
-0.000416 1.000000 -0.000143
-0.000283 1.000000 -0.000242
-0.000169 1.000000 -0.000380
-0.000072 1.000000 -0.000456
0.000082 1.000000 -0.000444
0.000172 1.000000 -0.000389
0.000295 1.000000 -0.000210
0.000417 1.000000 -0.000199
0.000532 1.000000 -0.000021
0.000554 1.000000 0.000033
0.000350 1.000000 0.000199
0.000258 1.000000 0.000299
0.002513 -0.999962 0.008294
-0.002435 -0.999966 0.007867
-0.002551 -0.999961 0.008420
0.002140 -0.999964 0.008248
0.005610 -0.999973 0.004783
0.008228 -0.999962 0.002824
0.010345 -0.999946 -0.000622
0.011598 -0.999930 -0.002359
0.008661 -0.999955 -0.003887
0.004619 -0.999971 -0.006012
0.001106 -0.999962 -0.008615
-0.000002 -0.999943 -0.010639
-0.002226 -0.999946 -0.010155
-0.002224 -0.999962 -0.008401
-0.005098 -0.999970 -0.005910
-0.006919 -0.999968 -0.003930
-0.010971 -0.999940 -0.000650
-0.010530 -0.999944 0.000410
-0.008263 -0.999958 0.003940
-0.005836 -0.999974 0.004160
80
1 0 1 2 0 1 2 1
1 1 3 2 1 2 2 1
1 2 4 5 2 3 3 1
1 5 4 6 3 3 4 1
1 4 7 6 3 5 4 1
1 6 7 8 4 5 6 1
1 6 8 9 4 6 7 1
1 9 8 10 7 6 8 1
1 8 11 10 6 9 8 1
1 10 11 12 8 9 10 1
1 10 12 13 8 10 10 1
1 13 12 14 10 10 11 1
1 12 15 14 10 12 11 1
1 14 15 16 11 12 13 1
1 14 16 17 11 13 13 1
1 17 16 18 13 13 14 1
1 18 19 20 14 14 15 1
1 18 20 21 14 15 15 1
1 22 23 24 16 17 18 1
1 22 25 23 16 16 17 1
1 26 25 22 19 16 16 1
1 27 26 22 19 19 16 1
1 28 26 27 20 19 19 1
1 28 29 26 20 20 19 1
1 30 29 28 21 20 20 1
1 31 30 28 21 21 20 1
1 32 30 31 22 21 21 1
1 32 33 30 22 22 21 1
1 34 33 32 23 22 22 1
1 35 34 32 23 23 22 1
1 36 37 34 24 24 23 1
1 38 37 36 25 24 24 1
1 39 38 36 25 25 24 1
1 40 41 38 26 26 25 1
1 42 41 40 27 26 26 1
1 43 42 40 27 27 26 1
1 44 45 46 28 29 30 1
1 46 45 47 30 29 31 1
1 48 46 47 32 30 31 1
1 48 47 49 32 31 33 1
1 1 48 49 1 32 33 1
1 1 49 23 1 33 17 1
1 50 1 23 34 1 17 1
1 50 23 51 34 17 35 1
1 52 50 51 36 34 35 1
1 52 51 53 36 35 37 1
1 54 52 53 38 36 37 1
1 54 53 55 38 37 39 1
1 56 54 55 40 38 39 1
1 56 55 57 40 39 41 1
1 58 56 57 42 40 41 1
1 58 57 59 42 41 43 1
1 60 58 59 44 42 43 1
1 59 61 60 43 45 44 1
1 44 60 61 28 44 45 1
1 61 45 44 45 29 28 1
1 62 63 64 46 47 48 1
1 64 65 62 48 49 46 1
1 66 62 65 50 46 49 1
1 62 66 67 46 50 51 1
1 68 67 66 52 51 50 1
1 67 68 69 51 52 53 1
1 70 69 68 54 53 52 1
1 69 70 71 53 54 55 1
1 72 71 70 56 55 54 1
1 71 72 73 55 56 57 1
1 74 73 72 58 57 56 1
1 73 74 75 57 58 59 1
1 76 75 74 60 59 58 1
1 75 76 77 59 60 61 1
1 77 78 79 61 62 63 1
1 78 77 76 62 61 60 1
1 79 80 81 63 64 65 1
1 80 79 78 64 63 62 1
1 81 64 63 65 48 47 1
1 64 81 80 48 65 64 1
1 38 39 40 25 25 26 1
1 34 35 36 23 23 24 1
1 19 18 16 14 14 13 1
1 2 3 4 2 2 3 1
"Regroup01" 1 1
10
1 -0.460569 0.500264 -1.438677 0.000000 0.000000 -1
1 1.230699 0.500264 -0.889151 0.000000 0.000000 -1
1 0.474342 0.500264 -1.438677 0.000000 0.000000 -1
1 1.230699 0.500264 0.889151 0.000000 0.000000 -1
1 1.543370 0.500264 0.000000 0.000000 0.000000 -1
1 -0.460569 0.500264 1.438677 0.000000 0.000000 -1
1 0.474342 0.500264 1.438677 0.000000 0.000000 -1
1 -1.543797 0.500264 0.000000 0.000000 0.000000 -1
1 -1.216925 0.500264 0.889151 0.000000 0.000000 -1
1 -1.216925 0.500264 -0.889151 0.000000 0.000000 -1
1
0.000000 1.000000 0.000000
8
1 0 1 2 0 0 0 1
1 1 3 4 0 0 0 1
1 3 5 6 0 0 0 1
1 5 7 8 0 0 0 1
1 7 0 9 0 0 0 1
1 5 0 7 0 0 0 1
1 0 5 1 0 0 0 1
1 1 5 3 0 0 0 1
"cover" 1 2
14
1 2.035416 0.499392 -0.000984 1.000000 0.000000 -1
1 -1.500084 0.499392 -2.000361 0.000000 1.000000 -1
1 -2.036033 0.499392 -0.000808 0.000000 0.000000 -1
1 1.499467 0.499392 -2.000360 1.000000 1.000000 -1
1 -2.035903 0.499392 -0.001955 1.000000 0.000000 -1
1 1.094222 0.499392 2.002097 0.000000 1.000000 -1
1 2.035545 0.499392 -0.002131 0.000000 0.000000 -1
1 -1.093413 0.499392 2.002096 1.000000 1.000000 -1
1 -2.036145 0.499392 -0.001955 1.000000 0.000000 -1
1 -2.033944 0.499392 1.108360 1.000000 1.000000 -1
1 -1.093421 0.499392 2.002097 0.000000 1.000000 -1
1 1.094322 0.499392 2.002036 1.000000 0.000000 -1
1 2.035511 0.499392 1.108031 1.000000 1.000000 -1
1 2.035719 0.499392 -0.001279 0.000000 1.000000 -1
1
0.000000 1.000000 0.000000
6
1 0 1 2 0 0 0 3
1 0 3 1 0 0 0 3
1 4 5 6 0 0 0 3
1 4 7 5 0 0 0 3
1 8 9 10 0 0 0 3
1 11 12 13 0 0 0 3

Materials: 3
"step colour"
0.266667 0.203922 0.827451 1.000000
0.270588 0.282353 0.760784 1.000000
0.000000 0.000000 0.000000 1.000000
0.000000 0.000000 0.000000 1.000000
0.000000
1.000000
""
""
"Material01"
0.082353 0.984314 0.352941 0.840000
0.360784 0.956863 0.258824 0.840000
0.000000 0.000000 0.000000 0.840000
0.000000 0.000000 0.000000 0.840000
0.000000
0.840000
""
""
"Material01"
0.200000 0.200000 0.200000 0.000000
0.800000 0.800000 0.800000 0.000000
0.000000 0.000000 0.000000 0.000000
0.000000 0.000000 0.000000 0.000000
0.000000
0.000000
""
""

Bones: 0
